6 6 6 6 6 6 6 6 6 6 6 6 6 6 6 6 6 6 6 6 6 6 6 6 6 6 6 6 6 6 
6 6 6 6 6 6 6 6 6 6 6 6 6 6 6 6 6 6 6 6 6 6 6 6 6 6 6 6 6 6 
6 6 6 6 6 6 6 6 6 6 6 6 6 6 6 6 6 6 6 6 6 6 6 6 6 6 6 6 6 6 
6 6 6 6 6 6 6 6 6 6 6 6 6 6 6 6 6 6 6 6 6 6 6 6 6 6 6 6 6 6 
6 6 6 6 6 6 6 6 6 6 6 6 6 6 6 6 6 6 6 6 6 6 6 6 6 6 6 6 6 6 
6 6 6 6 6 6 6 6 6 6 6 6 6 6 6 6 6 6 6 6 6 6 6 6 6 6 6 6 6 6 
6 6 6 6 6 1 1 1 1 1 1 1 1 1 1 1 1 1 1 1 1 1 1 1 6 6 6 6 6 6 
6 6 6 6 6 1 0 0 0 0 0 0 3 0 0 0 0 0 0 0 0 0 0 1 6 6 6 6 6 6 
6 6 6 6 6 1 0 0 0 0 0 0 0 0 0 0 0 0 0 0 0 0 0 1 6 6 6 6 6 6 
6 6 6 6 6 1 0 0 0 0 0 0 0 0 0 0 0 0 0 0 0 0 0 1 6 6 6 6 6 6 
6 6 6 6 6 1 0 0 0 0 0 0 0 0 0 0 0 0 0 0 0 0 0 1 6 6 6 6 6 6 
6 6 6 6 6 1 0 0 0 0 0 0 0 0 0 0 0 0 0 0 0 0 0 1 6 6 6 6 6 6 
6 6 6 6 6 1 0 0 0 0 0 0 0 0 0 0 0 0 0 0 0 0 0 1 6 6 6 6 6 6 
6 6 6 6 6 1 0 0 0 0 0 0 0 0 0 0 1 0 1 0 0 0 0 1 6 6 6 6 6 6 
6 6 6 6 6 1 0 0 0 0 0 0 0 0 0 0 0 0 0 1 0 0 0 1 6 6 6 6 6 6 
6 6 6 6 6 1 0 0 0 0 0 0 0 1 0 0 0 0 0 0 1 0 0 1 6 6 6 6 6 6 
6 6 6 6 6 1 0 0 0 0 0 1 0 0 0 0 0 0 0 0 1 0 0 1 6 6 6 6 6 6 
6 6 6 6 6 1 3 0 0 0 0 0 0 0 0 0 0 0 1 0 0 0 0 1 6 6 6 6 6 6 
6 6 6 6 6 1 0 0 0 0 1 0 0 0 0 0 0 0 0 0 0 0 0 1 6 6 6 6 6 6 
6 6 6 6 6 1 0 0 0 1 0 0 0 0 0 0 0 1 0 0 0 0 0 1 6 6 6 6 6 6 
6 6 6 6 6 1 0 0 0 0 0 0 0 0 0 1 0 0 0 0 4 0 0 1 6 6 6 6 6 6 
6 6 6 6 6 1 0 0 0 1 0 0 0 0 1 0 0 0 5 5 5 5 5 1 1 1 1 1 1 6 
6 6 6 6 6 1 0 0 0 0 0 1 0 1 0 0 0 0 5 5 5 5 5 0 0 0 0 3 1 6 
6 6 6 6 6 1 0 0 0 0 0 0 0 1 0 0 0 4 5 5 2 5 5 0 0 0 0 0 1 6 
6 6 6 6 6 1 0 0 0 0 0 0 1 0 0 0 0 0 5 5 5 5 5 0 0 0 0 0 1 6 
6 6 6 6 6 1 0 0 0 0 0 0 0 0 0 0 0 0 5 5 5 5 5 4 0 0 0 0 1 6 
6 6 6 6 6 1 1 1 1 1 1 1 1 1 1 1 1 1 1 1 1 1 1 1 1 1 1 1 1 6 
6 6 6 6 6 6 6 6 6 6 6 6 6 6 6 6 6 6 6 6 6 6 6 6 6 6 6 6 6 6 
6 6 6 6 6 6 6 6 6 6 6 6 6 6 6 6 6 6 6 6 6 6 6 6 6 6 6 6 6 6 
6 6 6 6 6 6 6 6 6 6 6 6 6 6 6 6 6 6 6 6 6 6 6 6 6 6 6 6 6 6 
12 7
6 17
27 22
-1 -1
-1 -1
-1 
-1 
1 1 1 1 1 1 1 1 1 1 1 1 1 1 1 1 1 1 1 1 1 0 0 1 0 1 0 1 0 1 0 1 0 1 0 1 0 1 0 1 0 1 0 -1 
-1 
-1 
1001000
1
